     .......................................        
   ..........................#.................   
 ...............................................  
................................................. 
........@.........................................
..................................................
 ........OOOOOOOOOO.............................. 
 ..............X..O..........k................... 
  .........X......O.............................  
       ......................................     
