                      k.....................        
                      .                    .      
                      .                    .      
                      .                    .      
........@........................................#
.................................................#
                      .                            
                      .                            
     X.................                           
